
NO ./pics/north.png
SO ./pics/south.png
WE ./pics/west.png
EA ./pics/east.png

F 23,107,135
C 218,255,251

111111111111111111111111111111
 10000000000000000000000000001
  100000000000000000000000001
   100000000000E000000000001
    10000000000000000000001
     100000000000000000001
      1111111110111111111
       10000000000000001
        100000000000001
         1000000000001
          10000000001
           100000001
            1000001
             10001
              101
               1
