
NO ./textures/north.png
SO ./textures/south.png
WE ./textures/west.png
EA ./textures/east.png

F 23,107,135
C 218,255,251


111111111111111111111111111111
111111111110000000011111111111
111111111110000000011111111111
111111111110000000011111111111
100000000000000000000000000001
100000000000000N00000000000001
100000000000000000000000000001
111111111110000000011111111111
111111111110000000011111111111
111111111110000000011111111111
111111111111111111111111111111