NO ./pics/tux.png
SO ./pics/tux.png
WE ./pics/tux.png
EA ./pics/tux.png

F 255,255,255
C 0,0,0


                               1111111111111
                             111111111111111111
                            111111111111111111111
                            11111111111111111111111
                           1111111111111111111111111
                          111111111111111111111111111
                          111000111111110000111111111
                          1100000011111000000011111111
                          1100100011110001100011111111
                          1101110011110011110001111111
                          1100000111110001100011111111
                          1111111111111000000011111111
                          1100000000000111111111111111
                           1100000000000000001111111111
                           111000000000000011101111111111
                           1101100000000111000001111111111
                          110000100000010000000001111111111
                        111100000111111000000000000000111111111
                      111100000000000000000000000000111111111
                    111110000000000000000000000000001111111111
                   11111000000000000000000000000000011111111111
                  11111100000000000000000000000000000111111111111
                 1111111000000000000000000000000000000111111111111
                1111110000000000000000000000000000000000111111111111
                11110000000000000000000000000000000000001111111111111
               1111100000000000000000000000000000000000000111111111111
              11110000000000000000000000000000000000000000111111111111
             111110000000000000000000000000000000000000000111111111111
            1111110000000000000000000N000000000000000000001111111111111
          11111111000000000000000000000000000000000000000011111111111111
        1111111111000000000000000000000000000000000000000011111111111111
     1111001111111000000000000000000000000000000000000000011111111111111
    1000000000001100000000000000000000000000000000000000111111111111111
   10000000000000011000000000000000000000000000000000011011111111111001
  10000000000000000011110000000000000000000000000000010000111111110000011
 1000000000000000000001111100000000000000000000000001000000001100000000011
100000000000000000000000111100000000000000000000000010000000000000000000111
1000000000000000000000000011000000000000000000000000100000000000000000000001
 1000000000000000000000000011000000000000000000000010000000000000000000000001
  100000000000000000000000001100000000000000000011110000000000000000000000001
  10000000000000000000000000011100000000000001111111000000000000000000000011
  100000000000000000000000000111111111111111111111110000000000000000000111
   11000000000000000000000000111111111111111111111110000000000000000011
     1111000000000000000000001111110000000111111111100000000000000011
         11111100000000000001110000000000000000000000110000000000011
          111111111111111111111111111111111111111111111111111111111
